111111111111111111111111111
100001000000000000000000001
10P0001000X000X00C000111111
100X0110000X000000000000001
100000000C00000001000000001
10000011000C00000000C000C01
10000110000000000000E000001
111111111111111111111111111