11111111
10P000C1
10X0E011
11111111