11111111
1000P001
10000001
1C001001
1000E101
10001001
11111111